SO ./textures/Purple.png

NO ./textures/Green.png

EA ./textures/Blue.png

WE ./textures/Gray.png



C 158,234      ,     		 242

F 244, 156,187


    1111111111111111111111111 1111
    1000000000000000000100001 11 1
    1001000000000000000001111 1111
11111000000000000001000001
11111100000000N0001000001
1001000000100000001000001
1001000000000000001000001
1001000000001000001000001
1111111111111111111111110