
SO ./textures/texture_4.png

EA ./textures/texture_6.png

WE ./textures/texture_10.png

NO ./textures/texture_5.png


F 25,82,42
C 223, 227,255


        1111111111111111111111111 11111  
111111111011000001110000000000001 11010
1110000000000000000000000000000S1 11111
11111111111111111111111111111111
