
SO ./textures/grass_south.png

NO ./textures/stone_north.png

EA ./textures/brick_east.png

WE ./textures/wood_west.png


C 25,100,233

F 0,10,0

        1111111111111111111111111
        1000000000110000000000001
        1011000001110000000000001
        1001000000000000000000001
111111111011000001110000000000001
100000000011000001110111111111111
1111N111111111011100000010001
11110111111111011101010010001
11000000111010111000000000001
10000000000000011000000100001
10000000000000001101010010001
110000011101010111110111100111
11110111 1110111 111111110001
11111111 1111111 111111111111
